###########
#    #    #
#    #    #
#         #
#         #         
#    #    #
#         #
#         #
#    #    #
#    #    #
###########